-16
16
-9
8
011101111110111111011111101111110
011101111110111111011111101111110
011101111110111111011111101111110
011101111110111111011111101111110
000000000000000000000000000000000
011101111111111111111111101111110
011101111111111111111111101111110
011101111111111111111111101111110
011101111111111111111111101111110
011101111111111111111111101111110
011101111111111111111111101111110
011101111111111111111111101111110
000000000000000000000000000000000
000000000001000000100000000000000
111000000001000000100000000111000
111000000001000000100000000111000
000000000001000000100000000000000
000001111111111111111111100000000
