-16
15
-9
12
01110111111000000001111110111000
01110111111000000001111110111000
01110111111000000001111110111000
01110111111000000001111110111000
01110111111000000001111110111000
01110111111000000001111110111000
01110111111000000001111110111000
01110111111000000001111110111000
00000000000000000000000000000000
01110000000000000000000000111111
01110000000000000000000000111111
01110000000000000000000000111111
01110000000000000000000000111111
01110000000000000000000000111111
01110000000000000000000000111111
01110000000000000000000000111111
00000000000000000000000000000000
00000000000100000010000000000000
11100000000100000010000000011100
11100000000100000010000000011100
00000000000100000010000000000000
00000111111111111111111110000000
