-16
15
-9
12
01110111111011111101111110111111
01110111111011111101111110111111
01110111111011111101111110111111
01110111111011111101111110111111
01110111111011111101111110111111
01110111111011111101111110111111
01110111111011111101111110111111
01110111111011111101111110111111
00000000000000000000000000000000
01110111111111111111111110111111
01110111111111111111111110111111
01110111111111111111111110111111
01110111111111111111111110111111
01110111111111111111111110111111
01110111111111111111111110111111
01110111111111111111111110111111
00000000000000000000000000000000
00000000000100000010000000000000
11100000000100000010000000011100
11100000000100000010000000011100
00000000000100000010000000000000
00000111111111111111111110000000
